0,2,0,0
1,1,1,1,1,1,1,1,1,1,1,1
1,1,1,1,1,1,2,1,1,1,1,1
1,1,1,1,1,2,1,2,1,1,1,1
1,1,1,1,9,1,8,1,2,1,1,1
1,1,1,1,1,2,1,2,1,1,1,1
1,1,1,1,1,1,2,1,1,1,1,1
1,1,1,1,1,1,1,1,1,1,1,1