0,0,2,2
1,1,1,1,1,1,1,1,1,1,1,1
1,4,4,4,1,1,1,1,4,4,4,1
1,4,1,1,1,1,1,1,1,1,4,1
1,4,1,4,4,4,4,4,4,1,4,1
1,4,1,1,1,1,1,1,1,1,4,1
1,4,4,4,1,1,1,1,4,4,4,1
1,1,1,1,1,1,1,1,1,1,1,1
10,10,10,10,10,10,10,13,10,10,10,10
10,10,10,10,10,10,10,10,10,10,10,10
10,10,10,10,10,10,13,10,10,10,10,10
10,10,10,10,10,10,10,10,10,10,10,10
10,10,10,10,10,10,10,10,13,10,10,10
10,10,10,10,10,10,10,10,10,10,10,10
10,10,10,10,10,10,10,10,10,10,10,10