2,0,0,1
1,1,1,1,1,1,1,1,1,1,1,1
1,2,1,2,1,2,2,1,2,1,2,1
1,1,1,1,1,1,1,1,1,1,1,1
1,2,1,2,1,2,2,1,2,1,2,1
1,1,1,1,1,1,1,1,1,1,1,1
1,2,1,2,1,2,2,1,2,1,2,1
1,1,1,1,1,1,1,1,1,1,1,1
10,10,14,14,10,10,10,10,10,14,14,10
10,10,10,10,10,10,10,10,10,10,10,10
10,10,10,10,10,10,10,10,10,10,10,10
10,10,10,10,10,10,10,10,10,10,10,10
14,10,10,10,10,10,10,10,10,10,10,14
14,10,10,10,10,10,10,10,10,10,10,14
10,10,10,10,10,10,10,10,10,10,10,10