1,1,1,1,1,1,1,1,1,1,1,1
1,5,1,1,5,1,1,6,1,1,6,1
1,1,1,1,1,1,1,1,1,1,1,1
1,5,1,1,5,1,1,6,1,1,6,1
1,1,1,1,1,3,3,1,1,1,1,1
1,5,1,3,5,3,3,6,3,1,6,1
1,1,1,3,3,3,3,3,3,1,1,1