0,0,0,1
00,00,00,00,00,00,12,12,00,00,00,00,00,00
00,01,01,01,01,01,01,01,01,01,01,01,01,00
00,01,02,02,02,02,02,02,02,02,02,02,01,00
00,01,02,01,01,05,01,01,06,01,01,02,01,00
12,01,02,01,05,01,01,01,01,06,01,02,01,12
00,01,02,01,01,01,01,01,01,01,01,02,01,00
00,01,02,02,02,02,01,01,02,02,02,02,01,00
00,01,01,01,01,01,01,01,01,01,01,01,01,00
00,00,00,00,00,00,12,12,00,00,00,00,00,00
20,20,20,20,20,20,20,20,20,20,20,20,20,20
20,20,20,20,20,20,20,20,20,20,20,20,20,20
20,20,20,20,20,20,20,20,20,20,20,20,20,20
20,20,20,20,20,20,20,20,20,20,20,20,20,20
20,20,20,20,20,20,20,20,20,20,20,20,20,20
20,20,20,20,20,20,20,20,20,20,20,20,20,20
20,20,20,20,20,20,20,20,20,20,20,20,20,20
20,20,20,20,20,20,20,20,20,20,20,20,20,20
20,20,20,20,20,20,20,20,20,20,20,20,20,20
30,30,30,30,30,30,30,30,30,30,30,30,30,30
30,30,30,30,30,30,30,30,30,30,30,30,30,30
30,30,30,30,30,30,30,30,30,30,30,30,30,30
30,30,30,30,30,30,30,30,30,30,30,30,30,30
30,30,30,30,30,30,30,30,30,30,30,30,30,30
30,30,30,30,30,30,30,30,30,30,30,30,30,30
30,30,30,30,30,30,30,30,30,30,30,30,30,30
30,30,30,30,30,30,30,30,30,30,30,30,30,30
30,30,30,30,30,30,30,30,30,30,30,30,30,30