2,0,0,1
00,00,00,00,00,00,12,12,00,00,00,00,00,00
00,18,18,18,18,18,18,18,18,18,18,18,18,00
00,18,02,18,02,18,02,02,18,02,18,02,18,00
00,18,18,18,18,18,18,18,18,18,18,18,18,00
12,18,02,18,02,18,02,02,18,02,18,02,18,12
00,18,18,18,18,18,18,18,18,18,18,18,18,00
00,18,02,18,02,18,02,02,18,02,18,02,18,00
00,18,18,18,18,18,18,18,18,18,18,18,18,00
00,00,00,00,00,00,12,12,00,00,00,00,00,00
20,20,20,20,20,20,20,20,20,20,20,20,20,20
20,20,20,24,24,20,20,20,20,20,20,24,24,20
20,20,20,20,20,20,20,20,20,20,20,20,20,20
20,20,20,20,20,20,20,20,20,20,20,20,20,20
20,20,20,20,20,20,20,20,20,20,20,20,20,20
20,24,20,20,20,20,20,20,20,20,20,20,20,20
20,24,20,20,20,20,20,20,20,20,20,20,24,20
20,20,20,20,20,20,20,20,20,20,20,20,24,20
20,20,20,20,20,20,20,20,20,20,20,20,20,20
30,30,30,30,30,30,30,30,30,30,30,30,30,30
30,30,30,30,30,30,30,30,30,30,30,30,30,30
30,30,30,30,30,30,30,30,30,30,30,30,30,30
30,30,30,30,30,30,30,30,30,30,30,30,30,30
30,30,30,30,30,30,30,30,30,30,30,30,30,30
30,30,30,30,30,30,30,30,30,30,30,30,30,30
30,30,30,30,30,30,30,30,30,30,30,30,30,30
30,30,30,30,30,30,30,30,30,30,30,30,30,30
30,30,30,30,30,30,30,30,30,30,30,30,30,30