0,0,2,2
0,0,0,0,0,10,11,0,0,0,0,0
0,1,1,1,1,1,1,1,1,1,1,1,1,0
0,1,4,4,4,1,1,1,1,4,4,4,1,0
0,1,4,1,1,1,1,1,1,1,1,4,1,0
0,1,4,1,4,4,4,4,4,4,1,4,1,12
0,1,4,1,1,1,1,1,1,1,1,4,1,0
0,1,4,4,4,1,1,1,1,4,4,4,1,0
0,1,1,1,1,1,1,1,1,1,1,1,1,0
0,0,0,0,0,10,11,0,0,0,0,0
10,10,10,10,10,10,10,13,10,10,10,10
10,10,10,10,10,10,10,10,10,10,10,10
10,10,10,10,10,10,13,10,10,10,10,10
10,10,10,10,10,10,10,10,10,10,10,10
10,10,10,10,10,10,10,10,13,10,10,10
10,10,10,10,10,10,10,10,10,10,10,10
10,10,10,10,10,10,10,10,10,10,10,10