0,2,0,0
00,00,00,00,00,10,11,00,00,00,00,00
00,01,01,01,01,01,01,01,01,01,01,01,01,00
00,01,01,01,01,01,01,02,01,01,01,01,01,00
00,01,01,01,01,01,02,01,02,01,01,01,01,00
12,01,01,01,01,09,01,08,01,02,01,01,01,12
00,01,01,01,01,01,02,01,02,01,01,01,01,00
00,01,01,01,01,01,01,02,01,01,01,01,01,00
00,01,01,01,01,01,01,01,01,01,01,01,01,00
00,00,00,00,00,10,11,00,00,00,00,00
16,10,10,10,10,10,10,10,10,10,10,16
10,10,10,10,10,10,10,10,10,10,10,10
10,10,10,10,10,10,10,10,10,10,10,10
10,10,10,10,10,10,10,10,10,10,10,10
10,10,10,10,10,10,10,10,10,10,10,10
10,10,10,10,10,10,10,10,10,10,10,10
16,10,10,10,10,10,10,10,10,10,10,16