2,0,1,0
4,4,4,4,4,1,1,4,4,4,4,4
4,1,1,1,4,1,1,1,1,4,1,4
4,1,4,1,4,1,4,4,1,4,1,4
1,1,4,1,4,1,1,4,1,4,1,1
4,1,4,1,4,4,1,4,1,4,1,4
4,1,4,1,1,1,1,4,1,1,1,4
4,4,4,4,4,1,1,4,4,4,4,4
10,10,10,10,10,10,10,10,10,10,10,10
10,10,12,10,10,10,10,10,10,10,12,10
10,10,10,10,10,10,10,10,10,10,10,10
10,10,10,10,10,10,10,10,10,10,10,10
10,10,10,12,10,10,10,10,10,10,10,10
10,10,10,10,10,10,10,10,10,10,10,10
10,10,10,10,10,10,10,10,10,10,10,10