2,0,1,0
0,0,0,0,0,10,11,0,0,0,0,0
0,4,4,4,4,4,1,1,4,4,4,4,4,0
0,4,1,1,1,4,1,1,1,1,4,1,4,0
0,4,1,4,1,4,1,4,4,1,4,1,4,0
12,1,1,4,1,4,1,1,4,1,4,1,1,12
0,4,1,4,1,4,4,1,4,1,4,1,4,0
0,4,1,4,1,1,1,1,4,1,1,1,4,0
0,4,4,4,4,4,1,1,4,4,4,4,4,0
0,0,0,0,0,10,11,0,0,0,0,0
10,10,10,10,10,10,10,10,10,10,10,10
10,10,12,10,10,10,10,10,10,10,12,10
10,10,10,10,10,10,10,10,10,10,10,10
10,10,10,10,10,10,10,10,10,10,10,10
10,10,10,12,10,10,10,10,10,10,10,10
10,10,10,10,10,10,10,10,10,10,10,10
10,10,10,10,10,10,10,10,10,10,10,10