2,1,1,1
00,00,00,00,00,00,10,11,00,00,00,00,00,00
00,01,01,01,01,01,01,01,01,01,01,01,01,00
00,01,05,01,01,05,01,01,06,01,01,06,01,00
00,01,01,01,01,01,01,01,01,01,01,01,01,00
14,01,05,01,01,05,01,01,06,01,01,06,01,14
00,01,01,01,01,01,03,03,01,01,01,01,01,00
00,01,05,01,03,05,03,03,06,03,01,06,01,00
00,01,01,01,03,03,03,03,03,03,01,01,01,00
00,00,00,00,00,00,10,11,00,00,00,00,00,00
20,20,20,20,20,20,20,20,20,20,20,20,20,20
20,20,20,20,20,20,20,20,20,20,20,20,20,20
20,20,20,20,20,20,20,20,20,20,20,20,20,20
20,20,20,20,20,20,20,20,20,20,20,20,20,20
20,20,20,20,20,20,20,20,20,20,20,20,20,20
20,20,20,20,20,20,20,20,20,20,20,20,20,20
20,20,20,20,20,20,20,20,20,20,20,20,20,20
20,20,20,20,20,20,20,20,20,20,20,20,20,20
20,20,20,20,20,20,20,20,20,20,20,20,20,20
30,30,30,30,30,30,30,30,30,30,30,30,30,30
30,30,30,30,30,30,30,30,30,30,30,30,30,30
30,30,30,30,30,30,30,30,30,30,30,30,30,30
30,30,30,30,30,30,30,30,30,30,30,30,30,30
30,30,30,30,30,30,30,30,30,30,30,30,30,30
30,30,30,30,30,30,30,30,30,30,30,30,30,30
30,30,30,30,30,30,30,30,30,30,30,30,30,30
30,31,30,32,30,33,30,34,30,35,30,36,30,30
30,30,30,30,30,30,30,30,30,30,30,30,30,30
