2,1,1,1
0,0,0,0,0,10,11,0,0,0,0,0
0,1,1,1,1,1,1,1,1,1,1,1,1,0
0,1,5,1,1,5,1,1,6,1,1,6,1,0
0,1,1,1,1,1,1,1,1,1,1,1,1,0
12,1,5,1,1,5,1,1,6,1,1,6,1,12
0,1,1,1,1,1,3,3,1,1,1,1,1,0
0,1,5,1,3,5,3,3,6,3,1,6,1,0
0,1,1,1,3,3,3,3,3,3,1,1,1,0
0,0,0,0,0,10,11,0,0,0,0,0
20,20,20,20,20,20,20,20,20,20,20,20
20,20,20,20,20,20,20,20,20,20,20,20
20,20,20,20,20,20,20,20,20,20,20,20
20,20,20,20,20,20,20,20,20,20,20,20
20,20,20,20,20,20,20,20,20,20,20,20
20,20,20,20,20,20,20,20,20,20,20,20
20,20,20,20,20,20,20,20,20,20,20,20