0,1,0,0
0,0,0,0,0,10,11,0,0,0,0,0
0,7,7,7,7,7,7,7,7,7,7,7,7,0
0,7,7,7,7,7,7,7,7,7,7,7,7,0
0,7,7,7,7,7,7,7,7,7,7,7,7,0
12,7,7,7,7,7,7,7,7,7,7,7,7,12
0,7,7,7,7,7,7,7,7,7,7,7,7,0
0,7,7,7,7,7,7,7,7,7,7,7,7,0
0,7,7,7,7,7,7,7,7,7,7,7,7,0
0,0,0,0,0,10,11,0,0,0,0,0