0,3,2,0
0,0,0,0,0,10,11,0,0,0,0,0
0,1,1,1,1,1,1,1,2,2,2,2,2,0
0,1,1,1,1,1,1,1,1,1,2,2,2,0
0,1,1,1,1,1,1,1,1,1,1,2,2,0
12,1,1,1,1,1,1,1,1,15,1,1,1,12
0,1,1,1,1,1,1,1,1,1,1,2,2,0
0,1,1,1,1,1,1,1,1,1,2,2,2,0
0,1,1,1,1,1,1,1,2,2,2,2,2,0
0,0,0,0,0,10,11,0,0,0,0,0