0,0,0,1
0,0,0,0,0,10,11,0,0,0,0,0
0,1,1,1,1,1,1,1,1,1,1,1,1,0
0,1,2,2,2,2,2,2,2,2,2,2,1,0
0,1,2,1,1,5,1,1,6,1,1,2,1,0
12,1,2,1,5,1,1,1,1,6,1,2,1,12
0,1,2,1,1,1,1,1,1,1,1,2,1,0
0,1,2,2,2,2,1,1,2,2,2,2,1,0
0,1,1,1,1,1,1,1,1,1,1,1,1,0
0,0,0,0,0,10,11,0,0,0,0,0