2,0,1,0
00,00,00,00,00,10,11,00,00,00,00,00
00,04,04,04,04,04,01,01,04,04,04,04,04,00
00,04,01,01,01,04,01,01,01,01,04,01,04,00
00,04,01,04,01,04,01,04,04,01,04,01,04,00
12,01,01,04,01,04,01,01,04,01,04,01,01,12
00,04,01,04,01,04,04,01,04,01,04,01,04,00
00,04,01,04,01,01,01,01,04,01,01,01,04,00
00,04,04,04,04,04,01,01,04,04,04,04,04,00
00,00,00,00,00,10,11,00,00,00,00,00
10,10,10,10,10,10,10,10,10,10,10,10
10,10,12,10,10,10,10,10,10,10,12,10
10,10,10,10,10,10,10,10,10,10,10,10
10,10,10,10,10,10,10,10,10,10,10,10
10,10,10,12,10,10,10,10,10,10,10,10
10,10,10,10,10,10,10,10,10,10,10,10
10,10,10,10,10,10,10,10,10,10,10,10