4,1,1,1
1,1,1,1,1,1,1,1,1,1,1,1
1,1,1,1,1,1,1,1,1,1,1,1
1,1,2,1,1,1,1,1,1,2,1,1
1,1,1,1,1,1,1,1,1,1,1,1
1,1,2,1,1,1,1,1,1,2,1,1
1,1,1,1,1,1,1,1,1,1,1,1
1,1,1,1,1,1,1,1,1,1,1,1
10,10,10,10,10,10,10,12,10,10,10,10
10,10,10,10,10,10,10,10,10,10,10,10
10,10,10,10,12,10,12,10,10,10,10,10
10,10,10,10,10,12,10,10,10,10,10,10
10,10,10,10,10,10,10,10,10,10,10,10
10,10,12,10,10,10,10,10,10,10,10,10
10,10,10,10,10,10,10,10,10,10,10,10