2,3,0,0
0,0,0,0,0,10,11,0,0,0,0,0
0,1,1,1,1,1,1,1,1,1,1,1,1,0
0,1,1,1,1,1,1,1,1,1,1,1,1,0
0,1,1,1,1,1,2,2,1,1,1,1,1,0
12,1,1,1,1,1,2,2,1,1,1,1,1,12
0,1,1,1,1,1,2,2,1,1,1,1,1,0
0,1,1,1,1,1,1,1,1,1,1,1,1,0
0,1,1,1,1,1,1,1,1,1,1,1,1,0
0,0,0,0,0,10,11,0,0,0,0,0
20,20,20,20,20,20,20,20,21,20,20,20
20,20,20,20,20,20,20,20,20,20,20,20
20,20,20,21,20,20,20,20,20,20,20,20
21,20,20,20,20,20,20,20,20,20,20,20
20,20,20,21,20,20,20,20,20,20,20,20
20,21,20,20,20,20,20,20,20,20,20,20
20,20,20,20,20,20,20,20,21,20,20,20