2,3,0,0
1,1,1,1,1,1,1,1,1,1,1,1
1,1,1,1,1,1,1,1,1,1,1,1
1,1,1,1,1,2,2,1,1,1,1,1
1,1,1,1,1,2,2,1,1,1,1,1
1,1,1,1,1,2,2,1,1,1,1,1
1,1,1,1,1,1,1,1,1,1,1,1
1,1,1,1,1,1,1,1,1,1,1,1
10,10,10,10,10,10,10,10,11,10,10,10
10,10,10,10,10,10,10,10,10,10,10,10
10,10,10,11,10,10,10,10,10,10,10,10
11,10,10,10,10,10,10,10,10,10,10,10
10,10,11,10,10,10,10,10,10,10,10,10
10,11,10,10,10,10,10,10,10,10,10,10
10,10,10,10,10,10,10,10,11,10,10,10